XXPPXRRRRXXPPXXXGGXX-RRRRXPPXXXXXXXRRRRXX-XXPPXHHXPPPPXXJJRRPP-PPPPXRRXPP<XWWWWWWWW-WWWWWWWWWWWWWWWWWWWW
XXPPXRRRRXXPPXXXGGXX-RRRRXPPXXRRRRXRRRRXX-XXPPXHHXPPPPXXJJRRPP-PPPPXRRXPP<XWWWWWWWW-WWWWWWWWWWWWWWWWWWWW
XXPPXRRRRXXPPXXXGGXX-RRRRXPPXXRRRRXRRRRXX-XXPPXHHXPPPPXXJJRRPP-PPPPXRRXPP<XWWWWWWWW-WWWWWWWWWWWWWWWWWWWW
XXX.................-.....XXXXRRRRXXXXXXX-PPXX................-........XX<XWWWWWWWW-WWWW.............WWW
RRR.XRRXXXPPXXXRRRRX-XPPX.EEXPPXXXRRPPXPP-PPXX.XXXFFX.PPXXXXXX-XXPPXCC.XX<XWWWWWWWW-WWWW.XBBXRRXXPPX.WWW
RRR.XRRXXXPPXXXRRRRX-XPPX.EEXPPXXXRRPPXPP-PPXX.PPXFFX.PPXXXXXX-XXPPXCC.XX<XWWWWWWWW-WWWW.XBBXRRXXPPX.WWW
RRR.XRRXXXPPXXXRRRRX-XPPX.EEXPPXXXRRPPXPP-XXXX.PPXFFX.PPXXXPPX-XXPPXCC.XX<XWWWWWWWW-WWWW.XBBXRRXXPPX.WWW
XXX.....XXXXX.......-........XXXXXXX.....-.....PPXXXX.XXXXXPPX-XPPXXXX.XX<XWWWWWWWW-WWWW.XXXXXPPXXXX.WWW
XXXXPPX.KKXRR.PPXXXX-XPPXXXX.DDXRRRR.RRXX-XXXXXXXXXPP.DDXPPPPX-XPPXXPP.XX<XXXXXXXXX-XXXX.XXPPXPPXJJX.WWW
RRRXPPX.KKXRR.PPXXXX-XPPXXXX.DDXRRRR.RRXX-PPWWWWWWXPP.DDXPPXXX-XPPXXPP.XX<<<<<<<<<<-<<<<.RRPPXPPXJJX.WWW
RRRXPPX.KKXRR.PPXXXX-XPPXXXX.DDXRRRR.RRXX-PPWWWWWWXPP.DDXPPXXX-XXXXXPP.XXXXXXXXXXXX-XXX<.RRPPXXXXJJX.WWW
RRRX..........XXXPPX-XXXXXXX.........XXXX-PPWWWWWWXXX.........-....................-.....RRXXXX......WWW
XXXX.RRRRR.PPXPPXPPX-XRRXRRX.PPXXXXX.IIRR-RRXPPRRRXRR.XXXXRRRX-XKKRRRR.AAXXXRR.XXXX-XEE<.RRXPPX.WWWWWWWW
PPXX.RRRRR.PPXPPXPPX-XRRXRRX.PPXPPXX.IIRR-RRXPPRRRXRR.XXPPRRRX-XKKRRRR.AAXXXRR.XXXX-XEE<.RRXPPX.WWWWWWWW
PPXX.RRRRR.PPXPPXXXX-XRRXRRX.PPXPPRR.IIRR-RRXPPRRRXRR.GGPPRRRX-XKKRRRR.AAXXXRR.XRRX-XEE<.RRXPPX.WWWWWWWW
PPXX.XXXXX..........-........XPPPPRR.....-............GGPPXXXX-XXXXXXX.XXXXXXX.XRRX-XX<<........WWWWWWWW
XXRR.PPXRRXXAAX.XPPX-PPXXBB.PPPPXXRRPPPPX-XXXRRXRRXPP.GGXXXPPX-RRXXXPP.XPPXRRX.XRRX-PP<PPPPXXHH.WWWWWWWW
XXRR.PPXRRXXAAX.XPPX-PPXXBB.PPPPXXXXPPPPX-XXXRRXRRXPP.XXXXXPPX-RRXXXPP.XPPXRRX.XXXX-PP<PPPPXXHH.WWWWWWWW
XXRR.PPXRRXXAAX.XPPX-PPXXBB.PPXXXXXXPPPPX-XXXRRXRRXPP.XXXXXPPX-RRXXXPP.XPPXRRX.XXXX-PP<PPPPXXHH.WWWWWWWW
--------------------------------------------------------------------------------------------------------
PPPP.FFXRRRRPPX.XPPX-PPXXRR.RRXPPXRRRRXPP-PPXXRRRRXRR.XXXXXXXX-XXXXXXX.XPPXXXX.XXPP-XX<XXXXXXXX.WWWWWWWW
PPPP.FFXRRRRPPX.XPPX-PPXXRR.RRXPPXRRRRXPP-PPXXRRRRXRR.XXPPXRRX-XXXXRRR.XPPXXRR.PPPP-PP<XXXXFFRR.WWWWWWWW
PPPP.FFXRRRRPPX.XPPX-PPXXRR.RRXPPXRRRRXPP-PPXXRRRRXRR.RRPPXRRX-RRRXRRR.XPPXXRR.PPPP-PP<<<XXFFRR.WWWWWWWW
XXXX................-....................-............RRPPXRRX-RRRXRRR.RRXXXRR.PPXX-PPXX<XXFFRR.WWWWWWWW
XRRX.XPPXXXPPXRRJJRR-XXXEEXRRRPP.XXXBBXXX-XXXXXXXXXXX.RRXXXXXX-RRR.....RRXXXXX.....-............WWWWWWWW
XRRX.XPPXXXPPXRRJJRR-RRXEEXRRRPP.XXXBBPPX-XXXXFFRRRRX.XXXXHHXX-XXX.XGGXRRXRRBB.WWWW-RRAA<XXIIXX.WWWWWWWW
XRRX.XPPXXXPPXRRJJRR-RRXEEXRRRPP.RRXBBPPX-PPXXFFRRRRX.XXNNHHXX-XXX.XGGXXXXRRBB.WWWW-RRAA<XXIIXX.WWWWWWWW
WW..........XXXXXXXX-RRXXXXXXXXX.RRXXXPPX-PPXXFFRRRRX.XXNNHHXX-XXX.XGGXXXXRRBB.WWWW-RRAA<<<IIXX.WWWWWWWW
WW.PPXXXXII.PPRRRRPP-XXXXXXX.....RRXXXXXX-PPX...........NN....-................WWWW-XRRXLL<XPPX.WWWWWWWW
WW.PPXPPXII.PPRRRRPP-PPXPPKK.XXAAXRRXXPPX-PPX.XXXXRRXXXXXRRRRX-XXXRRDD.XWWWWWW.WWWW-XRRXLL<XPPX.WWWWWWWW
WW.PPXPPXII.PPRRRRPP-PPXPPKK.XXAAXRRXXPPX-PPX.XXXXRRXXXXXRRRRX-PPXRRDD.XWWWWWW.WWWW-XRRXLL<XPPX.WWWWWWWW
WW.XXXPPXXX.XXXXXXXX-PPXPPKK.XXAAXRRXXPPX-PPX.XXXXRRPPXXXRRRRX-PPXRRDD.XWWWWWW.....-............WWWWWWWW
WW.HHPPXXPP.PPXPPXXX-RRXPPRR.............-........XXPPXXRRXXRR-PPXXXRR.PPXXWWWXKKXX-XJJPPX<XPPWWWWWWWWWW
WW.HHPPXXPP.PPXPPXXX-RRXPPRR.XPPXRRRRGGXX-RRRRXDD.XXPPXXRRXXRR-XXXXXRR.PPXXWWWXKKXX-XJJPPX<XPPWWWWWWWWWW
WW.HHPPXXPP.PPXPPXXX-RRXPPRR.XPPXRRRRGGXX-RRRRXDD.XMMMXXRRXXRR-XXXXXRR.PPXXWWWXKKXX-XJJPPX<XPPWWWWWWWWWW
WW..................-........XPPXRRRRGGPP-RRRRXDD..MMM........-........XXXXXXXXXXXX-RRXXXX<XWWWWWWWWWWWW
WWWWWWWWWWWWWWWWWWWW-WWWWWWWWPPXXPPXPPXPP-XPPXXPPXPPXXXXXXPPXX-PPXXIIRRRRXXWWWWXXPP-RRXXPP<XWWWWWWWWWWWW
WWWWWWWWWWWWWWWWWWWW-WWWWWWWWPPXXPPXPPXPP-XPPXXPPXPPXXXXXXPPXX-PPXXIIRRRRXXWWWWXXPP-RRXXPP<XWWWWWWWWWWWW
WWWWWWWWWWWWWWWWWWWW-WWWWWWWWPPXXPPXPPXXX-XPPXXPPXPPXXXXXXPPXX-PPXXIIRRRRXXWWWWXXPP-XXXXPP<XWWWWWWWWWWWW
